0 6 0 0 0
6 5 2 4 2
1 0 3 0 0
0 5 0 3 0
0 0 1 4 0
