0 0 0 0 0 0 0 0
0 4 0 8 3 0 0 0
0 0 8 1 6 5 0 0
0 0 0 0 0 0 0 0
0 0 0 0 0 0 0 0
0 0 1 6 3 5 0 0
0 4 2 9 0 0 0 0
0 0 0 0 0 0 9 2
